111111111111111
1CE00000C000PC1
111111111111111