111111111111111111111111111111
1E0000000000000C00000C00000C01
101001010010000010100100000001
101001001010101000100100000001
1P0000000C00C0000000000000C001
100000000000000C00000C00000C01
101001010010000010100100000001
101001001010101000100100000001
100000000C00C0000000000000C001
100000000000000C00000C00000C01
101001010010000010100100000001
101001001010101000100100000001
100000000C00C0000000000000C001
101001010010000010100100000001
101001001010101000100100000001
111111111111111111111111111111