11111111111111111111111111111111111111111111111111111
1E0C0000C0000C000000000000000000000000000000000000001
100000C0000P00000000000000000000000000000000000000001
10000111111000000000000000000000000000000000000000001
1000000C000000000000000000000000000000000000000000001
1000C0000C000C000000000000000000000000000000000000001
10000000000000000000000000000000000000000000000000001
11111111111111111111111111111111111111111111100000111
11111111111111111111111111111111111111111111110000011
100C0000C0000C000000000000000000000000000000000000001
100000C0000000000000000000000000000000000000000000001
10000111111000000000000000000000000000000000000000001
1000000C000000000000000000000000000000000000000000001
1000C0000C000C000000000000000000000000000000000000001
10000000000000000000000000000000000000000000000000001
11111111111111111111111111111111111111111111000000001
11111111111111111111111111111111111111111111100000001
10C0000C0000C0000000000000000000000000000000000000001
100000C0000000000000000000000000000000000000000000001
10000111111000000000000000000000000000000000000000001
1000000C000000000000000000000000000000000000000000001
1000C0000C000C000000000000000000000000000000000000001
10000000000000000000000000000000000000000000000000001
10000000000000000000000000000000000000000000000000001
11111111111111111111111111111111111111110000000001111
100C0000C0000C000000000000000000000000000000000000001
100000C0000000000000000000000000000000000000000000001
11111111111111111111111111111111111111111111111111111
