111111111111111111111111111111111111111111111111111111111111111
1E0C0000C0000C0000000000000000000000000000000000000000000000001
100000C0000P000000000000000000000000000000000000000000000000001
100001111110000000000000000000000000000000000000000000000000001
1000000C0000000000000000000000000000000000000000000000000000001
1000C0000C000C0000000000000000000000000000000000000000000000001
100000000000000000000000000000000000000000000000000000000000001
111111111111111111111111111111111111111111111000001100000000001
111111111111111111111111111111111111111111111100000100000000001
100C0000C0000C0000000000000000000000000000000000000000000000001
100000C00000000000000000000000000000000000000000000000000000001
100001111110000000000000000000000000000000000000000000000000001
1000000C0000000000000000000000000000000000000000000000000000001
1000C0000C000C0000000000000000000000000000000000000000000000001
100000000000000000000000000000000000000000000000000000000000001
111111111111111111111111111111111111111111110000000000000000001
111111111111111111111111111111111111111111111000000000000000001
10C0000C0000C00000000000000000000000000000000000000000000000001
100000C00000000000000000000000000000000000000000000000000000001
100001111110000000000000000000000000000000000000000000000000001
1000000C0000000000000000000000000000000000000000000000000000001
1000C0000C000C0000000000000000000000000000000000000000000000001
100000000000000000000000000000000000000000000000000000000000001
100000000000000000000000000000000000000000000000000000000000001
111111111111111111111111111111111111111100000000011100000000001
100C0000C0000C0000000000000000000000000000000000000000000000001
100000C00000000000000000000000000000000000000000000000000000001
100001111110000000000000000000000000000000000000000000000000001
1000000C0000000000000000000000000000000000000000000000000000001
1000C0000C000C0000000000000000000000000000000000000000000000001
100000000000000000000000000000000000000000000000000000000000001
100000000000000000000000000000000000000000000000000000000000001
111111111111111111111111111111111111111100000000011100000000001
100C0000C0000C0000000000000000000000000000000000000000000000001
100000C00000000000000000000000000000000000000000000000000000001
100000000000000000000000000000000000000000000000000000000000001
111111111111111111111111111111111111111100000000011100000000001
100C0000C0000C0000000000000000000000000000000000000000000000001
100000C00000000000000000000000000000000000000000000000000000001
111111111111111111111111111111111111111111111111111111111111111