11111
1E011
100C1
1P001
11111
